abella-danger	Female pornographic actress
adriana-chechik	Female pornographic actress
age-play	Roleplaying in which a subject acts (or is treated) as if they were a different age (use ‘age-difference’ for subjects of significantly different ages)
alexa-pearl	Female pornographic actress
alexis-texas	Female pornographic actress
alisai	Female adult content creator
alternative	Hairstyles, make-up, fashion, tattoos, or piercings outside of the mainstream (includes emo, scene, goth, and cyberpunk) 
amanda-cerny	Female influencer
amateur	Subject is not a professional actor, model, or content creator
anal	Features a sexual act in which something is inserted into the anus (penis, other body part, or toy)
angela-white	Female pornographic actress
anjelica-ebbi	Female pornographic actress
anri-okita	Japanese pornographic actress
asa-akira	Female pornographic actress
ashe-maree	Female adult content creator
ashley-alban	Female pornographic actress
asian	Subject has Asian facial features
ass	Subject’s ass (butt, rear, bottom, booty, buttocks) is prominent or featured
asshole	Subject’s asshole (butthole, anus) is prominent or featured
athletic	Subject is engaged in an athletic activity (sports/fitness), or is dressed in athletic apparel
ava-addams	Female pornographic actress
bailey-jay	Transsexual pornographic actress
bbw	Big Beautiful Woman/Women (glamourising overweight women) 
bby-pocahontas	Female adult content creator
bdsm	Scene involves bondage, discipline, dominance/submission, or sadism/masochism
beach	The setting is a beach (public or private)
berpl	Female adult content creator
big-boobs	Subject’s boobs (breasts, tits) are significantly larger than average
big-dick	Subject’s penis is significantly larger than average
bikini	Subject is wearing a skimpy two-piece swimsuit
bimbo	Subject is a hyper-sexualized, naive, and/or unintelligent woman
black	Subject has features typical of sub-Saharan African ancestry
blanc-noir	Female adult content creator
blonde	Subject has blonde hair
blowjob	A subject is giving (or is positioned to give) a blowjob
body-art	Features art made on, with, or consisting of, the human body
body-change	Shows physical change in subject’s body (breast growth, belly growth, etc.)
boobs	Subject’s boobs (breasts, tits, titties, knockers) are visible or featured
bras	A brassiere is prominent or featured 
breeding	Sex resulting in impregnation/ferilization (sperm meets egg)
brunette	Subject has BROWN hair (note that black hair is not brunette)
bryci	Female pornographic actress
bukkake	Subject is ejaculated on by three or more other participants
buttplug	Features a sex toy designed to be inserted into the anus
cam	The subject is viewed (or can be viewed) via webcam
cameltoe	Outline of pussy is seen through tight clothing (not just a bulge, but a bulge with a groove)
captions	Printed words added to an image to enhance or alter the content (for speech balloons use 'comics', for subtitles use 'subtitles')
carlie-jo	Female adult content creator
celebs	Subject is a mass media celebrity, known for something other than porn
cherubesque	Female adult content creator
chubby	Subject is overweight, but not obese (use 'fat' for an obese subject)
clothed	At least one of the subjects is *FULLY* clothed in *STREET CLOTHES*, even if some clothes are pulled aside
college	The setting appears to be at a college or university
comics	Drawn porn in a comic book style, usually with speech balloons
cosplay	Subject engages in costumed roleplay
creampie	Cum is ejaculated INSIDE a vagina or anus (use ‘cum-on-pussy’ for ejaculation on the outside of the pussy)
cuckold	Features an openly adulterous wife (her husband may or may not be present, but knows)
cum	Visible cum is prominent or featured
cumshot	Cum ejaculated from a penis (for cum already on a subject and no penis visible use 'cum')
cumslut	Subject clearly enjoys cum and/or being cummed on
curvy	Subject has big boobs and/or ass without appearing chubby
cute	The subject is attractive in a pretty or endearing way
dani-daniels	Female pornographic actress
deepthroat	Features a blowjob in which the entire erect penis goes deep into the mouth and throat
dillion-harper	Female pornographic actress
dolly-winks	Female pornographic actress
dresses	Subject is wearing a dress (not just a skirt)
eastern-europe	Subject comes from an Eastern European country
elsa-jean	Female pornographic actress
embarrassed	The subject appears to be embarrassed by what is happening (in Hentai, flushed cheeks can mean many things and only sometimes embarrassment)
emily-bloom	Female adult content creator
emmaglover	Female influencer
erin-ashford	Female adult content creator
european	Subject comes from a European country
eva-lovia	Female pornographic actress
eye-contact	Subject is looking at the camera 
facial	Features cum on a subject’s face
fake-boobs	Subject’s breasts have been augmented with surgical implants
faye-reagan	Female pornographic actress
feet	Feet are prominent or featured
femdom	Features BDSM with a female in the dominant role
fisting	All or most of a hand is inserted into a pussy or asshole
fit	Subject’s body is well toned (used especially with flat abdomen and visible ab-muscles)
flashing	Brief *PUBLIC* display of nudity, typically by pulling clothing aside (for non-public use ‘reveal’)
freckles	Clusters of small hyper-pigmented skin splotches in areas that get sun exposure
funsizedasian	Female adult content creator (this is the name of a *SPECIFIC* model)
furry	Contains anthropomorphic animal characters with human personalities and characteristics
futanari	A drawn subject has both female breasts and a male penis (may or may not also have a pussy)
gangbang	One subject is the focus of sexual activity from three or more other individuals
gape	Features an asshole or pussy remaining open without anything holding it open
gay	Features sexual activity (or interest) between two or more males
gianna-michaels	Female pornographic actress
gillian-barnes	Female adult content creator
ginger	Subject is a natural redhead, often with pale skin/freckles (use 'redhead' for hair dyed red)
gonewild	Adult Redditors show off their nude bodies (the subject should also be the poster)
group	Three or more individuals posing together (not engaged in sexual activity)
hairy	Subject has body hair *OTHER THAN* pubic hair OR has exceptionally bushy pubic hair
handjob	Features a penis stimulated by rubbing with the hand of another person
hardcore	Porn that features explicit depictions of sexual acts (usually depicts penetration)
hd	High definition photography or videography (usually 1080p minimum)
helga-lovekaty	Female adult content creator
hidori-rose	Female adult content creator
hips	Features a subject’s hips (used for front-view, use 'ass' for rear-view)
hitomi-tanaka	Female pornographic actress
holly-peers	Female influencer
hopelesssofrantic	Female adult content creator
incest	Role-play or fiction of sexual activity between members of a family
indian	Subject is from the Indian subcontinent or has ancestry from there
interracial	Sexual activity involving individuals of different races
jada-stevens	Female pornographic actress
janice-griffith	Female pornographic actress
japanese	Subject is from Japan or has Japanese ancestry
jeans	Subject is wearing jeans style pants
jem-wolfie	Female influencer
jenna-jade	Female adult content creator
jessica-nigri	Female influencer
katee-owen	Female pornographic actress
katya-clover	Female adult content creator
kelsi-monroe	Female pornographic actress
kendra-sunderland	Female pornographic actress
keriberry420	Female adult content creator
kim-kardashian	Female influencer
kimmy-granger	Female pornographic actress
korean	Subject is from Korea or has Korean ancestry
kylie-jenner	Female influencer
kylie-page	Female pornographic actress
lana-rhoades	Female pornographic actress
latina	Subject is form Latin America or has ancestry from there
leah-gotti	Female pornographic actress
legendarylootz	Female adult content creator
leggings	Subject is wearing form-fitting article of clothing over ass and legs, but not the feet (e.g. yoga pants)
legs	Subject’s lower legs (or legs AND thighs together) are prominent or featured (use ‘thigh’ for thighs alone)
lena-paul	Female pornographic actress
lesbian	Sexual activity between two or more females (not usually used in an FFM scene)
lexi-belle	Female pornographic actress
liara-roux	Female adult content creator
lily-ivy	Female adult content creator
lindsey-pelas	Female influencer
lingerie	Sexualized (often lacy or frilly) underwear that is intended to be seen (for daily-wear underwear use ‘bras’ and/or ‘panties’)
lisa-ann	Female pornographic actress
little-caprice	Female pornographic actress
liz103	Female adult content creator
madison-ivy	Female pornographic actress
malena-morgan	Female pornographic actress
mandy-muse	Female pornographic actress
maria-ryabushkina	Female pornographic actress
masturbation	A subject sexually stimulates himself/herself (for manual stimulation by another person use ‘handjob’ or ‘fingering’)
mature	Subject is middle aged or elderly, usually 40+
megan-rain	Female pornographic actress
melissa-debling	Female adult content creator
mia-malkova	Female pornographic actress
mia-melano	Female pornographic actress
mia-khalifa	Female Lebanese-American pornographic actress
middle-eastern	Subject is from Muslim Western-Asia or Northeast Africa, or has ancestry from there
mila-azul	Female adult content creator
milf	Mother I'd Like to Fuck' – a mother old enough to have teenagers, but still hot enough to fuck
mind-control	Subject’s mind is controlled by another (hypnosis, potions, psychic powers, etc.)
miss-alice18	Female adult content creator
movie	Features a sex scene from a non-pornographic film
my-cherry-crush	Female adult content creator
nadya-nabakova	Female pornographic actress
nekane	Female pornographic actress
nicole-aniston	Female pornographic actress
nipples	Nipple(s) are prominent or featured (use ’transparent’ for see-thru; use ‘pokies’ for nipple contour visible under clothes)
non-nude	 The subject is at least partially clothed, but no pussy, penis, asshole, or female nipples are visible (use 'clothed' for fully dressed in street clothing)
on-off	Two or more still images of the same subject, one with clothing and one without
one-piece	Any close fitting garment intended to be an entire outfit (tank swimsuit, leotard, wetsuit etc.)
oral	Features a sex act in which there is contact between the mouth and genitals
orgasm	A subject reaches sexual climax (usually used for females, while 'cumshot' is used for males)
outercourse	Features non-penetrative sex (handjob, titjob, thighjob, frottage, scissoring, etc.)
outside	The setting is outdoors
pale	Subject has notably pale skin
panties	Panties are prominent or featured
pee	Features urine
pegging	Features anal sex with a strap-on dildo
penis	Subject’s penis (dick, cock, pecker, prick) is visible or featured
petite	Features a female who is smaller and/or skinnier than average
piper-perri	Female pornographic actress
pornstar	Subject is a professional nude model or adult film performer
pov	Point Of View is from a participant in the scene, rather than an observer
pregnant	A subject is visibly pregnant
pubic-hair	The subject has visible pubic hair (can be bushy or trimmed)
public	The setting is public (outdoors is NOT public if in the wilderness or a private area)
pussy	A pussy (vulva, cunt, snatch, twat) is prominent
redhead	Subject has red hair (for natural red hair also use 'ginger')
religious	Subject is wearing religious clothing or jewelry, or the setting is religious
remy-la-croix	Female pornographic actress
riley-reid	Female pornographic actress
rimming	Features oral sex focused on the asshole (anilingus, rimjob)
rough	Features extremely vigorous sex, in which one subject is pushed close to their limits
rule-34	If it exists there is porn of it. Well known non-porn fictional characters placed in porn settings
sabrina-nichole	Female pornographic actress
sabrinalynnci	Female adult content creator
sara-j-underwood	Female influencer
sarahxxx	Female adult content creator
secretlittle	Female adult content creator
selfie	The subject is taking their own photo, either directly or in mirror
sexy-flower-water	Female adult content creator
shiny	Features shiny things in a porn setting (e.g. latex or leather clothing, oiled skin, etc.)
shirts	Button-down-the-front shirt (use ‘tops’ for other kinds of shirts)
shoes	The subject’s shoes are prominent or featured
shorts	The subject’s shorts are prominent or featured
siri	Female pornographic actress
sissy	Subject is a submissive, feminine appearing and/or acting male
skirts	The subject’s skirt is prominent or featured (use 'upskirt' for shots up under a skirt)
small-boobs	Subject’s boobs (breasts, tits) are significantly smaller than average
socks	Socks typically cover only the foot and part of the lower leg, and are often thicker than stockings 
sophie-dee	Female pornographic actress
squirting	Featuring fluid that is expelled from the vagina at orgasm
st-peach	Female streamer and influencer
stockings	Thin fabric coverings over the foot, leg, and part of the thigh (Not pantyhose. Not socks. Not leggings.)
stormi-maya	Female influencer
stoyaxxx	Female pornographic actress
strapon	A dildo worn in a harness at the crotch is prominent or featured
swimsuit	Subject is wearing a swimsuit (male or female, bikini or one-piece)
tanlines	Subject has distinct areas of tanned skin and untanned skin
tattoo	The subject’s tattoos are visible or featured
teen	Subject is (or appears to be) 18 or 19. Suspicions of anything younger should be reported!
tessa-fowler	Female adult content creator
thigh	The subject’s thigh is prominent or featured
thong	Features a garment with a only a thin strip of fabric passing between the buttocks
titfuck	Outercourse in which a penis is rubbed between the breasts
titty-drop	Subject lifts their top and breasts together, then allows their breasts to drop free and bounce
tops	Items of clothing that cover all/part of the area between the neck and waistline
tori-black	Female pornographic actress
toys	Features sex toys (e,g. dildo, vibrator, buttplug, pocket pussy, anal beads, etc.)
trans	Subject is visibly transgendered
transparent	See-thru fabric reveals a pussy, nipple, asshole, or penis (use 'x-ray' for seeing things inside body) 
trashy	Portrays low-class, no-class, white trash, or bimbo culture 
undressing	A subject is actively removing their clothing (clothing being removed, not already removed)
uniforms	The subject is wearing a uniform of some sort (schoolgirl, maid, nurse, cop, soldier, etc.)
vintage	Depicts porn of an earlier era, typically pre-1990
viola-bailey	Female pornographic actress
virtualgeisha	Female adult content creator
voyeur	A subject is observing sexual activity without participating
wet	Subject’s skin, hair, or clothing appear to be wet (for sweat use 'sweating', for vaginal fluid use 'grool')
wife	Subject must be identifiable as a wife by something *OTHER THAN* the title
xrxse	Female adult content creator
censored	Media has been censored in some way (e.g. black bars, pixelisation, etc.)
glasses	The subject is wearing glasses
pierced	The subject has piercings *OTHER THAN* traditional ear piercings
gloryhole	A penis is inserted through a hole in a wall for someone else to suck, jerk or fuck
double-penetration	A vagina and/or anus is penetrated by two penises or toys simultaneously
oiled	The subject’s skin is coated with oil
schoolgirl	Subject wears a costume associated with school (often a short skirt, blouse, and tie)
spit-roast	Subject is simultaneously penetrated both orally and either anally or vaginally
female-pov	Media shot from the Point Of View of a female subject
fingering	Rubbing or inserting fingers anally, vaginally, or orally
showering	The subject is showering
cum-in-mouth	Cum (semen) in the mouth or on the tongue of a subject
bondage	Subject is restained by INANIMATE materials (ropes, handcuffs, etc.) – use ‘manual restraint’ if restrained by another subject’s strength
sixty-nine	Position in which two subjects simultaneously perform oral sex on each other
choking	The subject’s neck is being held/squeezed in a way that could restrict breathing
braces	Features braces, used to align and straighten teeth
compilation	Media containing cuts from multiple distinct scenes
overwatch	Content related to the Overwatch videogame (e.g. cosplay,  SFM, 2D art, etc.)
cum-on-boobs	Cum (semen) on the subject's boobs
facefuck	Active penile thrusting into mouth/throat
ahegao	Facial expression with the eyes rolled up, the mouth open, and the tongue sticking out
facesitting	Sitting on a subject's face to receive cunnilingus or analingus, or for domination
short-hair	Subject has short hair (at or above the jawline)
tentacle	Media featuring tentacles
big-ass	Subject’s ass is significantly larger than average
sasha-grey	Female pornographic actress
threesome	Features three subjects interacting sexually (use 'group-sex' for more than three)
cumswap	Features individuals passing cum between mouths
60fps	Media with 60 frames per second or higher
grool	Vaginal lubrication produced upon sexual arousal
collar	Features an animal-type collar (use 'choker' for close-fitting necklace)
body-writing	Writing (typically demeaning) on the body
spank	Subject is being spanked, or has reddened ass / handprints (use ‘whip-marks’ for marks from impact toys)
cunnilingus	Features oral stimulation of the female genitals
x-ray	Transparent view of the body to reveal internal details
cowgirl	Position in which the female sits astride the male, facing him
reverse-cowgirl	Position in which the female sits astride the male, facing away from him
dildo	Features a dildo or other penis-like insertable toy (including vibrators)
latex	Involves people wearing latex/rubber
presenting	Subject is presenting their pussy or asshole for penetration, either bent over, or on back with legs up
collage	Simultaneously displays multiple images
pokemon	Features characters from the anime Pokémon
before-after	Media which simultaneously displays and compares a before scene and an after scene
fucking-machine	Sex involving a machine, such as dildo on an robotic arm (does not include androids)
cum-on-ass	Depicts cum on a subject’s ass
choker	Subject is wearing a choker or close-fitting necklace (use ‘collar’ for animal-type collar)
male-pov	Media shot from the Point Of View of a male subject
ffm-threesome	Two females and one male are interacting sexually
chastity	A subject is wearing a device intended to prevent sexual contact or activity
condom	Features the use of a condom
bestiality	Sexual interaction with animals or beasts (use ‘monster’ for humanoid beasts)
blindfold	Something placed over the eyes to disable the wearer's sight
gag	An object stuffed into the mouth to restrict speech
bisexual-male	Features a male sexually interacting with both males and females
pronebone	Position with one person lying flat on their stomach while the other penetrates them from behind
spit	Spit, saliva, drool, etc. are prominent or featured
mmf-threesome	Two males and one female are interacting sexually
maid	The subject is wearing a maid outfit
dancing	The subject is moving their body in rhythm to music
vibrator	A vibrating sex toy
uncircumcised	The subject's penis is uncircumcised
mutual-masturbation	Two or more individuals masturbating together
audio	The media contains audio or sound
cfnm	Clothed Female, Naked Male
perfect-loop	WebM or GIF that loops seamlessly
kiss	Two subjects are kissing (use 'cock-kiss' for kissing a penis)
riding	One subject is on top of and 'riding' another subject or toy
black-female	Features a black female
blowbang	The subject is giving (or is positioned to give) blowjobs to three or more penises
hair-pulling	The subject is being pulled or held by their hair
bathtub	The subject is in a bathtub
forced	One of the subjects is forced to do something and is obviously disliking it
ruined-orgasm	Stimulation is stopped just as the orgasm begins, resulting in a frustratingly unfulfilling orgasm
black-male	Features a black male
fat	Subject is significantly overweight, not just chubby
breast-suck	Subject is sucking or licking a nipple or breast
sybian	A saddle-like masturbation device that the subject sits astride
kendra-lust	Female pornographic actress
closeup	Shot is focused on a single body part or area of one or more subjects
femsub	Features BDSM with a female in the submissive role
bulge	Features a penis visible through clothes (not for distention caused by penetration)
monochrome	Media is in black &amp; white or grayscale
crying	One of the subjects is crying
nipple-clamps	Features clamps placed on the nipples
forced-orgasm	One of the subjects is forced to have an orgasm
edging	Repeatedly taking yourself (or being taken) almost to the point of orgasm, then stopping before climaxing
tongue	The tongue is a major focus of the media
lactation	Features milk from breasts
ball-sucking	One subject gently suckles upon another's scrotum
bbc	Features a Big Black Cock
pigtails	One of the subjects has pigtails
footjob	Subject uses their feet to stimulate another subject’s genitals
cockring	Ring worn around the penis for a stronger or longer-lasting erection
precum	Clear liquid oozing from the penis (not cum)
ass-to-mouth	A penis or toy is removed from an asshole and is immediately inserted in a mouth
girl-on-top	Female subject on top position
doggy-style	Subject on all-fours is vaginally or anally penetrated
faceless	Subject’s face is obscured, censored or cropped off
cross-dress	The subject is wearing opposite gender clothes (avoid with trans subjects)
balls	There are clearly visible testicles
colored-hair	The subject has hair dyed a non-natural color
softcore	Pornographic or erotic content that does not contain explicit depictions of sexual acts
upskirt	Media that focuses on a subject's underwear or genitals being viewed beneath a dress or skirt
underboob	The bottom part of the breast is seen, but *NOT THE NIPPLE*
struggle	Features efforts to get free of restraint or constriction
standing-sex	The subjects are standing up during sex
low-quality	Low quality content (poor resolution)
twerk	Dance move consisting of shaking the buttocks in squatting stance
heels	The subject is wearing high heel shoes
autofellatio	Features a subject giving themself a blowjob
thighjob	A penis is stimulated by rubbing it between the thighs
cumflation	The subject’s belly is distended by a volume of cum (use ‘abdominal-bulge’ for a bulge caused by penetration)
muscle	The subject has a muscular body type
shaved	The genitalia are shaved bald (NO PUBIC HAIR)
harem	Three or more women are sexual partners of one man
lip-biting	The subject bites on their lips
lesdom	Features BDSM in which a female dominates another female
painal	The subject is having a painful anal sex
twink	Gay male subjects with hairless, skinny body types, typically teenage (18+)
missionary	Sexual position where the partners are face-to-face, with one partner on their back, and the other on top of them between their legs
bodyshots	Cum on a subject’s body (usually restricted to cum on the torso)
christy-mack	Female pornographic actress
cum-covered-fucking	The subject has cum on their body or face and is still fucking
single-shot	The clip is a single continuous camera shot (no editing discontinuities)
hands-free-orgasm	Orgasm without the use of physical genital stimulation
boots	The subject is wearing boots
penetration	Shows the *MOMENT* of penile penetration (use ‘insertion’ for objects in orifices)
frot	Two penises rubbing together, typically in a gay context
malesub	Features BDSM with a male in the submissive role
flexible	The subject is displaying high levels of flexibility
corset	The subject is wearing a corset or bustier
triple-penetration	A vagina and/or anus is penetrated by three penises or toys simultaneously (use ‘airtight’ for mouth, pussy, and anus all filled)
fishnet	Stockings or other clothing that resemble a fishnet
futanari-on-male	A futanari subject is taking the dominant role with a male partner
long-hair	Subject has long hair (at or below mid-back, mid-breast, or mid-upper-arm)
guro	Grotesque erotic artwork often featuring death, torture, guts and mutilation
sideboob	The breast is glimpsed from the side, but the *NIPPLE REMAINS MOSTLY HIDDEN*
scissoring	Lesbian sex in which partners grind their pussies together (tribadism)
groping	Body parts (boobs/ass) being groped
cleavage	The hollow between a woman's breasts when supported, especially as exposed by a low-cut garment
insertion	Filling any orifice with a foreign object (use ‘penetration’ for moment of penile penetration)
cheerleader	The subject is acting as, or is dressed as a cheerleader
neko	A feminine subject has cat ears and/or a cat tail (but not furry)
abuse	The subject is experiencing abuse (ill-treatment, pain, or suffering)
reveal	Pulling aside clothing (or something else) to reveal intimate body parts
anal-creampie	Ejaculation in the anus
leather	The subject is wearing or using leather material
joi	Jerk off instructions
solo-trans	Only one transsexual subject, solo
massage	Non-sexual health and wellness body rubbing which may then progress to sexual activity
happy	The subject is visibly happy/smiling
trap	A feminine male who is easily confused for a female (use ‘femboy’ for feminine males who are clearly male)
prostate-stimulation	The subject’s prostate is being explicitly and intentionallly stimulated
brandi-love	Female pornographic actress
double-dildo	A dildo with two ends, which can be used by two people at the same time
bride	Features a subject wearing a wedding dress or wedding-like lingerie
torn-clothing	The subject’s clothing has holes ripped in it, or is torn away
rope	Rope, usually as part of bondage
elf	Features elf-like characters or cosplay (typically with pointed ears)
league-of-legends	Features characters from the videogame League of Legends
male-on-futanari	A male subject is taking the dominant role with a futanari partner
interspecies	The subjects are of different species
monster-girl	Mix or hybrid between a human female and a monster/animal (often with horns, tail, wings etc.)
smoking	The subject is smoking
horsecock	A horse’s penis, or a penis shaped like that of a horse (NOT simply a huge cock)
veiny-cock	A penis with prominent veins
pool	The setting is in or beside a swimming pool
lara-croft	Fictional character from the video game franchise Tomb Raider
face-down-ass-up	The subject's face is down with their ass upwards
split-screen	Clip simultaneously displays multiple camera angles (use 'collage' for still shots)
amazon-position	Woman rides her man in a reverse missionary position
goth	Subject’s hairstyle, makeup, and fashion are consistent with gothic subculture
cheating	Subject is cheating on significant other or spouse
bad-dragon	Fantasy ’creature’ dildo (Bad Dragon brand or similar)
emily-grey	Female pornographic actress
male-on-trans	A male subject is taking the dominant role with a trans partner
circumcised	The subject's penis is circumcised
shibari	Artistic Japanese-style rope bondage
fucklicking	Subject licks the genitals and/or anus of a couple while that couple is engaged in vaginal or anal intercourse
xev-bellringer	Female pornographic actress
maledom	Features BDSM with a male in the dominant role
trans-on-male	A trans subject is taking the dominant role with a male partner
teasing	Providing sexual stimulation while withholding full sex or release 
miss-banana	Female pornographic actress
snapchat-filter	Augmented reality effects added on/around the subject’s face (e.g. dog ears and muzzle, flower/butterfly crown, etc.)
bottomless	A (usually female) subject has no clothing covering their ass and genitals, but is otherwise FULLY clothed
bent-over	A subject is STANDING, bent at the waist to present their ass
larkin-love	Female pornographic actress
softie	A flaccid, non-erect penis
trans-on-female	A trans subject is taking the dominant role with a female partner
underwater	Submerged in water, often with the camera underwater as well
fake	The image has been digitally altered (to enhance size, add cum, alter gender, fake celeb nude, etc.) 
tanned	Subject has visibly tanned skin due to sun exposure or artificial tanning (add ‘tanlines’ if present)
licking	To draw the tongue over something, such as a body part
witcher	Depicts characters from the Witcher videogame series
succubus	female demon seductress
tail-plug	Featuring a butt-plug with an attached tail
boob-fondling	The subject's breasts are being fondled/massaged/rubbed
assjob	A penis is stimulated by rubbing it between the ass cheeks
freeuse	Society or situation in which a female is always available for sexual use by males (or vice versa)
abdominal-bulge	Penetration results in a visible bulge in the subject's abdomen (use ‘cumflation’ for belly swollen by cum)
soles	Features the soles of the feet
lips	The predominant focus is the subject's lips (mouth, not pussy)
suction-dildo	The subject is using a dildo with a suction cup
gloves	A performer is wearing one or more gloves
caught	Subject is caught nude or masturbating or having sex
cbt	Cock and ball torture
all-the-way-through	A penis/tentacle/toy enters the anus and exits the mouth (or vice versa)
beard	The subject has facial hair
scene-summary	Longer scene edited to show just a few seconds of each position
mask	The subject is wearing a mask but can still see (as opposed to a blindfold)
full-nelson	Sex position with arms placed under partner’s legs from behind, and fingers interlocked behind partner’s neck
subtitles	The dialogue is printed, typically at the bottom (for speech balloons use 'comics')
sweating	Sweating is is prominent or featured
black-hair	Features at least one subject with black colored hair
ebony	Subject is a black female
moaning	Audible moaning is prominently featured
orgy	Group sex with at least five participants (unlike a gangbang, no one person is the focus of the activity)
ponytail	Hair drawn back and tied at back of head, looking like a pony’s tail
thigh-gap	The space between a woman’s upper thighs when her legs are together
pokies	A nipple’s contour is visible beneath the fabric of clothing that covers it
cock-milking	Handjob or blowjob through a hole in a table
kneeling	Subject is kneeling (use ‘all fours’ if on hands and knees)
tickling	The subject is being tickled
lube	Artificial sexual lubricants are used
felching	Sucking a creampie out of a pussy or asshole
boobs-on-glass	Boobs pressed against glass and viewed from the other side
slow-motion	Media uses an effect where time appears to be slowed down
tail	The subject has a tail (use ’tailplug’ for buttplug with tail)
monster	Depicts a *HUMANOID* monster
curly-hair	Subject has curly hair
tit-slap	A subject’s boobs are slapped
small-penis	Subject’s penis is sigificantly smaller than average
impact-toy	Any implement used to strike a submissive (paddle, crop, flogger, whip, cane, etc.)
bear	Subject is a gay male with a stocky, hairy body
electricity	The subject is being electrically stimulated (TENS, violet wand, etc.)
humiliation	The subject is humiliated (shamed, demeaned, degraded, humbled)
metal-restraints	Metal bondage restraints (e.g. handcuffs, shackles)
face-slap	A subject is slapped in the face
suicidegirls	Models from the site SuicideGirls (typically branded with SG watermark)
toilet	A toilet is prominent or featured
throatpie	Ejaculation during deepthroating (deep in throat, not just in mouth)
flat-chest	A female or trans subject has nipples, but little (if any) breast tissue
thigh-highs	Depicts any leg covering that ends in mid-thigh (stockings, boots, socks, etc.)
suspension	A bondage subject hangs from tethers that support all or most of their weight
big-areolae	The hyperpigmented area surrounding the nipple is significantly larger than average
size-difference	There’s a notable difference in size between sexual partners
exercise	A subject is exercising or the setting is a workout gym
pasties	Adhesive patches cover a subject's nipples and areolae
garter-belt	Subject’s stockings are held up by a garter-belt (suspenders)
futanari-on-female	A futanari subject is taking the dominant role with a (non-futanari) female partner
casting	Subject is auditioning for a role in a porn film (first time doing porn)
group-sex	Four or more individuals engaged in sexual activity with each other
dakota-skye	Female pornographic actress
scat	Involves feces (shit, poop, crap)
sleeping	A subject is sleeping or unconscious
leash	A tether (rope, chain, strap, etc.) attached to a collar
pixel-art	Low-resolution digital art in which individual pixels are manipulated
disney	Features characters from Disney franchises
bunny-girl	A female dressed in a bunny outfit (or a bunny/girl hybrid)
realistic-art	Drawn porn without cartoonish facial features or exaggerated body proportions
topless	A (usually female) subject is nude above the waist, but is otherwise FULLY clothed
office	The setting is an office in a place of business
trans-on-trans	A trans subject interacts sexually with another trans subject
downblouse	Breast voyeurism involving looking down a subject’s blouse
stuck-in-wall	The subject’s body is embedded in a wall with parts on both sides
watermark	A logo or other branding graphic is superimposed over the image (or appears in a corner)
double-blowjob	Two subjects give a blowjob to the same penis, together
kenzie-reeves	Female pornographic actress
autocunnilingus	Features a subject performing cunnilingus on themself
lipstick	The subject’s lipstick is a *MAJOR* focus
whip-marks	Subject has visible marks or injuries resulting from a whipping, flogging, or caning (use 'spank' for handprint or diffuse redness)
cum-through-clothes	A subject ejaculates cum through or beneath their own clothing
jiggle	The jiggling of a body part is a major focus
cum-on-feet	Depicts cum on a subject’s feet
public-restroom	The setting is a public restroom
distracted	The subject is focused on some other task during sex
marvel	Featuring subjects from the Marvel comic-book/movie franchises
anal-hook	Curved metal bar (hook) inserted into the asshole (a tether is often attached)
goldenshower	One subject pisses on another subject
nurse	Subject is dressed as a nurse (real or cosplay)
festival-slut	A (typically female) subject is wearing lewd attire or doing lewd things at a festival or rave
post-orgasm	Genital stimulation is continued after orgasm, even to the point of discomfort
cum-in-panties	Cum ejaculated into or onto a pair of panties, worn or not
car	The subject is in, on, or beside a car or truck
cum-on-clothes	Depicts cum on top of clothing
harry-potter	Features characters from the Harry Potter books and movies
innie	Pussy in which the labia majora completely hide the labia minora (just outer lips with a slit) 
hucow	A human subject is dressed and/or treated like a cow
pantyhose	Sheer, tight-fitting legwear from waist to toes (Not stockings. Not leggings. Not yoga pants.)
pierced-nipple	The subject has pierced nipples
armpit-hair	Subject has visible armpit hair, natural or trimmed
pierced-tongue	The subject’s tongue is pierced
from-below	Low-angle camera perspective, looking up at the subject (worm's-eye view)
femboy	A feminine male, but clearly male (use ‘trap’ for a flat-chested subject with a penis who who might be confused for a female)
classroom	The setting is in a school classroom
spooning	Sexual partners lie on their sides, one behind the other, facing the same direction
ecchi	Playfully erotic, but non-explicit anime or manga
handbra	The subject hides her nipples with her hands or arms
hogtied	Bondage in which the wrists and ankles are all tied together behind the subject
ballbusting	Subject’s balls are hit, kicked, squeezed, or compressed
intoxicated	The subject is drunk or high
self-facial	Subject ejaculates cum onto their own face
forced-to-watch	Subject is forced to watch others having sex (in-person or on-screen)
braids	The subject has braided hair
pierced-bellybutton	The subject has a pierced bellybutton
prostitution	Money is exchanged for sex
western	Drawn porn lacking the characteristic stylistic influences of Japanese anime
blood	Blood is visible
pet-play	Depicts humans playing as pets, commonly with tail-plugs, ears, makeup, etc.
pierced-lip	The subject’s lip is pierced
cum-swallow	A subject swallows cum
breath-play	A subject’s air supply is intentionally cut off or limited
magic	Features the use of magic
pierced-nose	The subject’s nose is pierced
pierced-pussy	The subject’s pussy is pierced
party	The setting is a party
age-difference	A significant age difference between the subjects is a major focus (use ‘age-play’ for age roleplaying)
hand-in-panties	A subject’s hand is in their panties or another subject’s panties
pocket-pussy	Male masturbation sleeve (fleshlight, onahole, etc.)
remote-control	The subject is wearing a toy controlled remotely
scars	A subject has visible scars (e.g. battle, boob implant, c-section, etc.)
anal-beads	A chain of beads for insertion in a subject's anus
pierced-eyebrow	The subject’s eyebrow is pierced
tits-touching-tits	Two (or more) subjects with their boobs touching each other
nier-automata	Content related to the videogame Nier:Automata (2B, 9S, A2, etc.)
school	The setting is in a school
kitchen	The setting is in a kitchen
manual-restraint	Subject is held in place by the brute strength of another subject (as opposed to bondage)
pierced-penis	The subject’s penis is pierced
jockstrap	Subject is wearing a jockstrap (athletic supporter)
puffy-nipple	The areola puffs outward
siblings	The subjects are portraying siblings
star-wars	Depicts characters from the Star Wars franchise
white-hair	Features a subject with white colored hair
hanging-boobs	Pendulous boobs that swing when the subject is on all-fours or bent-over
keyholder	 A subject is in possession of the keys to someone else’s chastity device
cock-kiss	A subject’s penis is being kissed
rear-pussy	 A pussy viewed from the rear (typically with the subject on all-fours or bent-over)
dc-comics	Features characters from DC Comics franchises
nude	Subject is *FULLY* nude
open-mouth-gag	Subject is wearing a gag that holds the mouth open
secretary	One of the subjects is a secretary
fff-threesome	Three females are interacting sexually
sasha-foxxx	Female pornographic actress
hairy-ass	The subject has a notably hairy ass and/or asshole
armpit	The subject’s armpit is prominent or featured
bisexual-female	Features a female sexually interacting with both males and females
cei	Cum Eating Instructions – subject or narrator instructs the viewer to eat cum
quiver	A subject trembles during an intense orgasm
on-phone	Subject appears to be on the phone *while engaged in a sexual act*
confinement	The subject is being held in a restricted space (cage, cell, closet, box, etc.)
holiday	The scene has a holiday theme (Christmas, Valentines, Halloween, etc.)
saggy-boobs	Subject has boobs that droop or sag
apron	Subject is wearing an apron
pillory	A rigid bondage device with holes for the neck, wrists, and/or ankles (stocks, shrew's fiddle, etc.)
boat	The subject is on or near a boat
used-condom	Features a discarded condom OR a cum-filled condom on a penis
police	One or more of the subjects is a police officer (or other law enforcement)
mmm-threesome	Three males are interacting sexually
ttt-threesome	Three trans subjects are interacting sexually
oblivious-bystander	A non-participant is near sexual activity, but unaware of it
crop-top	A top or shirt short enough to leave the navel and lower ribs visible
ttm-threesome	Two trans subjects and one male are interacting sexually
ttf-threesome	Two trans subjects and one female are interacting sexually
underbun	The lower part of the ass sticks out beneath the clothing (like underboob)
mmt-threesome	  Two males and one trans subject are interacting sexually
fft-threesome	Two females and one trans subject are interacting sexually
tmf-threesome	One trans subject, one male, and one female are interacting sexually
skinny-dipping	A subject is nude or partially nude while in a natural body of water or pool
humor	Media presented in a way that is intended to be funny, comedic, or humorous
multiple-orgasm	A subject has more than one orgasm during a single scene
leather-restraints	Bondage restraints made of leather
long-nails	The subject’s fingernails are significantly longer than average, and are prominent or featured
airtight	Simultaneous penetration of mouth, vagina, and anus
cum-on-pussy	There is cum on the OUTSIDE of a pussy (use ‘creampie’ for cum *in* a pussy)
all-fours	The subject is on their hands and knees (if fucking, use ‘doggystyle’ instead)
medical-fetish	Fetish involving medical roleplay
weapon	The subject has a weapon (sword, gun, knife, etc.)
rear-entry	Inclusive of all sexual positions that feature vaginal or anal penetration from the rear
harness	Straps or bands form a webbed garment (can be used as a bondage restraint)
throbbing	A penis visibly pulsates during ejaculation
hotel	The setting is in a hotel or motel
bed	The subject is on a bed
knot	Bulbous erectile tissue at the base of the penis in dogs and other canines
bangs	The subject's hairstyle includes bangs
interview	The actress/actor is interviewed, usually before the sex scene
oviposition	Eggs are being laid in one of the subject’s orifices or body cavities
babysitter	Subject is portrayed in a babysitter role
penis-measure	A penis is shown with a ruler or compared to an object of known size
landing-strip	A subject’s pubic hair is closely trimmed, leaving only a narrow strip above the genitals
blue-eyes	A subject’s blue eyes are prominent or are a major focus
b/s-incest	Sexual role-play or fiction in which subjects portray a brother and sister
straitjacket	A subject is wearing a straitjacket
armbinder	A subject is being restrained by an armbinder / monoglove
green-eyes	A subject’s green eyes are prominent or are a major focus
panties-to-the-side	Subject’s panties are pulled to one side to reveal the genitals or allow penetration
mirror	A subject is seen reflected in a mirror
tomboy	A female subject exhibits characteristics or behaviors more typical of males
self-bondage	The subject uses restraints on themself for erotic pleasure
wedding-ring	The wedding ring of a subject is visible
barely-legal	The  actor/model appears to be under the age of consent, but is documented to be of legal age
sounding	Thin metal or plastic rods (sounds) are inserted into the urethra
small-areolae	The hyperpigmented area surrounding the nipple is significantly smaller than average
chest-hair	The subject has a hairy chest
f/d-incest	Sexual role-play or fiction in which subjects portray a father and daughter
crotchless	Subject is wearing pants or underwear with holes that expose the crotch
penis-awe	A subject is visibly shocked or impressed by another subject’s penis
goosebumps	A subject has goosebumps (gooseflesh)
double-anal	A subject is being penetrated anally by two penises or toys
double-vaginal	A subject is being penetrated vaginally by two penises or toys
dripping	A bodily fluid is dripping (cum, grool, precum, saliva, urine, breastmilk, etc.)
in-the-wild	Setting is in a wilderness or natural outdoor area (no lawns, cultivated gardens, public beaches, etc.)
non-human-skin-color	Subject’s skin is a non-natural color for human skin (blue, green, etc.)
sci-fi	The subject or setting is from science fiction (aliens, spaceships, laser weapons, etc.)
fantasy	The subject or setting is from fantasy fiction (dragons, orcs, elves, castles, magic, etc.)
cum-in-mid-air	A *STILL* image captures a cumshot in mid-air
nipple-play	Features sensitive touch of the nipples (by self or others)
crawling	A subject is crawling on all fours (use ‘all-fours’ if stationary)
m/s-incest	Sexual role-play or fiction in which subjects portray a mother and son
boxers	A subject is wearing men's boxer shorts underwear
briefs	A subject is wearing men's briefs underwear (jockey shorts)